AFAIK=As Far As I Know
AFK=Away From Keyboard
AI=Artificial Intelligence
ALU=Arithmetic Logic Unit
API=Application Programming Interface
ARPANET=Advanced Research Project Agency Network
ASAP=As Soon As Possible
ASCII=American Standard Code for Information Interchange
ATK=At The Keyboard
ATM=At The Moment
A3=Anytime, Anywhere, Anyplace
BAK=Back At Keyboard
BCZ=Because
BIOS=Basic Input Output System
BRB=Be Right Back
BRT=Be Right There
BTW=By The Way
B4=Before
B4N=Bye For Now
CAD=Computer Aided Design
CAE=Computer Aided Engineering
CD=Compact Disk
CD-ROM=Compact Disk Read Only Memory
CLI=Command Line Interface
CPU=Central Processing Unit
CV=Close Vote
CVer=Close Voter
CW=Community Wiki
DBMS=Data Base Management System
DV=Delete vote
ENIAC=Electronic Numerical Integrator And Calculator
FAQ=Frequently Asked Questions
FGITW=Fastest Gun in the West
FHRC=Free Hand Red Circle
FORTRAN=FORmula TRANslation
FC=Fingers Crossed
FTP=File Transfer Protocol
FWIW=For What It's Worth
FYI=For Your Information
FR=Feature Request
GAL=Get A Life
GB=Giga Bytes
GHz=Giga Hertz
GG=Good Game
GMTA=Great Minds Think Alike
GPRS=General Packet Radio Service
GR8=Great!
GSM=Global System for Mobile communication
GUI=Graphical User Interface
HNQ=Hot Network Questions
HTML=HyperText Markup Language
IMHO=In My Honest/Humble Opinion
IKR=I Know Right
IMO=In My Opinion
IOW=In Other Words
IRL=In Real Life
JPEG=Joint Photographic Experts Group
JRE=Java Runtime Environment
KB=Kilo Bytes
KHz=Kilo Hertz
KISS=Keep It Simple, Stupid
LMAO=Laugh My A.. Off
LAN=Local Area Network
LOL=Laughing Out Loud
LTNS=Long Time No See
L8R=Later
LQP=Low-Quality Posts
Meta SE=Meta Stack Exchange
MSO=Meta Stack Overflow
MB=Mega Bytes
MCVE=Minimal Complete Verifiable Example
MHz=Mega Hertz
MIDI=Musical Instrument Digital Interface
MTE=My Thoughts Exactly
NAA=Not An Answer
NARQ=Not a real Question
NC=Not Constructive
NLN=No longer needed
NRN=No Reply Necessary
OCR=Optical Character Recognition
OIC=Oh I See
OS=Operating System
OP=Original Poster
OT=Off-topic
PC=Personal Computer
PDF=Portable Document Format
Q&A=Questions and Answers
RA=Rude or abusive
RAM=Random Access Memory
ROM=Read Only Memory
ROFL=Rolling On The Floor Laughing
ROFLOL=Rolling On The Floor Laughing Out Loud
SO=Stack Overflow
SOIS=Stack Overflow Internet Services
SEI=Stack Exchange Inc.
SF=Server Fault
SDLC=Software Development Life Cycle
SQL=Structured Query Language
SU=Super User
THX=Thank You
TTYL=Talk To You Later
URL=Uniform Resource Locator
USB=Universal Serial Bus
UTF=Unicode Transformation Format
VGA=Video Graphics Array
VLQ=Very Low Quality
VTC=Vote to Close
VTD=Vote to Delete
VTR=Vote to Reopen
Wiki=Community Wiki
WWW=World Wide Web
WB=Welcome Back
WTG=Way To Go!
WWW=World Wide Web
WUF=Where Are You From?
XML=eXtensible Markup Language